SIZE 20 15
PLAYER_START 1.50 2.50
1,6 1,6 1,5  1,6 1,6 1,5  1,6 1,6 1,5  1,6 1,6 1,5  1,6 1,6 1,5  1,6 1,6 1,5  1,6 1,6 1,5  1,6 1,6 1,5  1,6 1,6 1,5  1,6 1,6 1,5  1,6 1,6 1,5  1,6 1,6 1,5  1,6 1,6 1,5  1,6 1,6 1,5  1,6 1,6 1,5  1,6 1,6 1,5  1,6 1,6 1,5  1,6 1,6 1,5  1,6 1,6 1,5  1,6 1,6 1,5  
1,6 1,6 1,5  1,6 1,6 1,5  1,6 1,6 1,5  1,6 1,6 1,5  1,6 1,6 0,0  1,6 1,6 0,0  1,6 1,6 1,5  1,6 1,6 0,0  1,6 1,6 0,0  1,6 1,6 1,5  1,6 1,6 0,0  1,6 1,6 0,0  1,6 1,6 0,0  1,6 1,6 0,0  1,6 1,6 0,0  1,6 1,6 0,0  1,6 1,6 0,0  1,6 1,6 1,5  1,6 1,6 0,0  1,6 1,6 1,5  
1,6 1,6 1,5  1,6 1,6 0,0  1,6 1,6 0,0  1,6 1,6 1,5  1,6 1,6 1,5  1,6 1,6 0,0  1,6 1,6 0,0  1,6 1,6 0,0  1,6 1,6 0,0  1,6 1,6 0,0  1,6 1,6 0,0  1,6 1,6 0,0  1,6 1,6 0,0  1,6 1,6 1,5  1,6 1,6 0,0  1,6 1,6 0,0  1,6 1,6 0,0  1,6 1,6 1,5  1,6 1,6 0,0  1,6 1,6 1,5  
1,6 1,6 1,5  1,6 1,6 0,0  1,6 1,6 0,0  1,6 1,6 1,5  1,6 1,6 0,0  1,6 1,6 0,0  1,6 1,6 1,5  1,6 1,6 1,5  1,6 1,6 1,5  1,6 1,6 1,5  1,6 1,6 1,5  1,6 1,6 1,5  1,6 1,6 0,0  1,6 1,6 1,5  1,6 1,6 0,0  1,6 1,6 1,5  1,6 1,6 0,0  1,6 1,6 0,0  1,6 1,6 0,0  1,6 1,6 1,5  
1,6 1,6 1,5  1,6 1,6 0,0  1,6 1,6 0,0  1,6 1,6 0,0  1,6 1,6 1,5  1,6 1,6 0,0  1,6 1,6 0,0  1,6 1,6 0,0  1,6 1,6 1,5  1,6 1,6 1,5  1,6 1,6 0,0  1,6 1,6 0,0  1,6 1,6 0,0  1,6 1,6 0,0  1,6 1,6 0,0  1,6 1,6 0,0  1,6 1,6 0,0  1,6 1,6 0,0  1,6 1,6 1,5  1,6 1,6 1,5  
1,6 1,6 1,5  1,6 1,6 1,5  1,6 1,6 0,0  1,6 1,6 0,0  1,6 1,6 0,0  1,6 1,6 0,0  1,6 1,6 0,0  1,6 1,6 1,5  1,6 1,6 0,0  1,6 1,6 0,0  1,6 1,6 1,5  1,6 1,6 0,0  1,6 1,6 0,0  1,6 1,6 1,5  1,6 1,6 0,0  1,6 1,6 1,5  1,6 1,6 1,5  1,6 1,6 0,0  1,6 1,6 0,0  1,6 1,6 1,5  
1,6 1,6 1,5  1,6 1,6 0,0  1,6 1,6 0,0  1,6 1,6 1,5  1,6 1,6 0,0  1,6 1,6 0,0  1,6 1,6 0,0  1,6 1,6 0,0  1,6 1,6 0,0  1,6 1,6 0,0  1,6 1,6 0,0  1,6 1,6 0,0  1,6 1,6 0,0  1,6 1,6 0,0  1,6 1,6 0,0  1,6 1,6 0,0  1,6 1,6 0,0  1,6 1,6 0,0  1,6 1,6 0,0  1,6 1,6 1,5  
1,6 1,6 1,5  1,6 1,6 1,5  1,6 1,6 0,0  1,6 1,6 0,0  1,6 1,6 0,0  1,6 1,6 0,0  1,6 1,6 0,0  1,6 1,6 0,0  1,6 1,6 0,0  1,6 1,6 0,0  1,6 1,6 0,0  1,6 1,6 0,0  1,6 1,6 0,0  1,6 1,6 0,0  1,6 1,6 1,5  1,6 1,6 0,0  1,6 1,6 0,0  1,6 1,6 1,5  1,6 1,6 0,0  1,6 1,6 1,5  
1,6 1,6 1,5  1,6 1,6 0,0  1,6 1,6 1,5  1,6 1,6 0,0  1,6 1,6 0,0  1,6 1,6 0,0  1,6 1,6 0,0  1,6 1,6 0,0  1,6 1,6 0,0  1,6 1,6 0,0  1,6 1,6 0,0  1,6 1,6 0,0  1,6 1,6 0,0  1,6 1,6 0,0  1,6 1,6 1,5  1,6 1,6 0,0  1,6 1,6 0,0  1,6 1,6 0,0  1,6 1,6 0,0  1,6 1,6 1,5  
1,6 1,6 1,5  1,6 1,6 0,0  1,6 1,6 1,5  1,6 1,6 0,0  1,6 1,6 0,0  1,6 1,6 0,0  1,6 1,6 0,0  1,6 1,6 1,5  1,6 1,6 0,0  1,6 1,6 0,0  1,6 1,6 1,5  1,6 1,6 0,0  1,6 1,6 0,0  1,6 1,6 0,0  1,6 1,6 0,0  1,6 1,6 1,5  1,6 1,6 0,0  1,6 1,6 0,0  1,6 1,6 0,0  1,6 1,6 1,5  
1,6 1,6 1,5  1,6 1,6 0,0  1,6 1,6 0,0  1,6 1,6 1,5  1,6 1,6 0,0  1,6 1,6 0,0  1,6 1,6 0,0  1,6 1,6 0,0  1,6 1,6 1,5  1,6 1,6 1,5  1,6 1,6 0,0  1,6 1,6 0,0  1,6 1,6 0,0  1,6 1,6 1,5  1,6 1,6 0,0  1,6 1,6 0,0  1,6 1,6 0,0  1,6 1,6 1,5  1,6 1,6 0,0  1,6 1,6 1,5  
1,6 1,6 1,5  1,6 1,6 1,5  1,6 1,6 0,0  1,6 1,6 0,0  1,6 1,6 0,0  1,6 1,6 0,0  1,6 1,6 1,5  1,6 1,6 1,5  1,6 1,6 1,5  1,6 1,6 1,5  1,6 1,6 1,5  1,6 1,6 1,5  1,6 1,6 0,0  1,6 1,6 1,5  1,6 1,6 0,0  1,6 1,6 0,0  1,6 1,6 0,0  1,6 1,6 0,0  1,6 1,6 0,0  1,6 1,6 1,5  
1,6 1,6 1,5  1,6 1,6 0,0  1,6 1,6 0,0  1,6 1,6 1,5  1,6 1,6 0,0  1,6 1,6 0,0  1,6 1,6 0,0  1,6 1,6 0,0  1,6 1,6 0,0  1,6 1,6 0,0  1,6 1,6 0,0  1,6 1,6 0,0  1,6 1,6 0,0  1,6 1,6 0,0  1,6 1,6 0,0  1,6 1,6 1,5  1,6 1,6 0,0  1,6 1,6 1,5  1,6 1,6 0,0  1,6 1,6 1,5  
1,6 1,6 1,5  1,6 1,6 0,0  1,6 1,6 1,5  1,6 1,6 0,0  1,6 1,6 0,0  1,6 1,6 0,0  1,6 1,6 0,0  1,6 1,6 0,0  1,6 1,6 1,5  1,6 1,6 0,0  1,6 1,6 0,0  1,6 1,6 0,0  1,6 1,6 0,0  1,6 1,6 1,5  1,6 1,6 0,0  1,6 1,6 0,0  1,6 1,6 0,0  1,6 1,6 1,5  1,6 1,6 0,0  1,6 1,6 1,5  
1,6 1,6 1,5  1,6 1,6 1,5  1,6 1,6 1,5  1,6 1,6 1,5  1,6 1,6 1,5  1,6 1,6 1,5  1,6 1,6 1,5  1,6 1,6 1,5  1,6 1,6 1,5  1,6 1,6 1,5  1,6 1,6 1,5  1,6 1,6 1,5  1,6 1,6 1,5  1,6 1,6 1,5  1,6 1,6 1,5  1,6 1,6 1,5  1,6 1,6 1,5  1,6 1,6 1,5  1,6 1,6 1,5  1,6 1,6 1,5  
